BACK	B AE K
CANCEL	K AE N S AH L
FORWARD	F AO R W ER D
FOUR	F AO R
GO	G OW
GOAL	G OW L
LEFT	L EH F T
MOVE	M UW V
NO	N OW
ONE	W AH N
ONE(2)	HH W AH N
POSITION	P AH Z IH SH AH N
RIGHT	R AY T
ROTATE	R OW T EY T
STOP	S T AA P
THREE	TH R IY
TO	T UW
TO(2)	T IH
TO(3)	T AH
TURN	T ER N
TWO	T UW
YES	Y EH S
